9 8
..#####.
###...#.
#.px..#.
###.x.#.
#.##x.#.
#.#...##
#x.xxx.#
#......#
########
........
........
.o......
.....o..
.o......
....o...
...o..o.
....o...
........