6 8
########
#..#...#
#..x...#
#p.#..##
#..#..##
########
........
........
........
........
.o......
........